11111111111111111111111111111111
10010000000C00000000000000C00001
10000000000000000000000000000001
1000011100000000000C000000000001
10000111000000000000000000000001
1000011111000000000000000C000001
10000111110000C00000000000000001
10000111110000000000000000000001
10000111110000000000000000000001
10000111110000000000000C00000001
10000111110000C00000000000000001
10000111110000000000000000000001
10000111110000000000000000000001
1000011111000C000000000000C00001
10000111110000000000000000000001
10000111110000000000C000C0000001
1P0011E0000000000000000000000001
11111111111111111111111111111111