111111111111111111111111111111111111111111
10010000000C00000000000000000000000C000001
100000000000000000000000000000000000000001
10000111000000000000000000000C000000000001
100001110000000000000000000000000000000001
100001111100000000000000C0000000000C000001
10000111110000C000000000000000000000000001
10000111110000000000000C000000000000000001
100001111100000000000000000000000000000001
100001111100000000000000000000000C00000001
10000111110000C000000000000000000000000001
1000011111000000000000000C0000000000000001
100001111100000000000000000000000000000001
1000011111000C000000000000C000000000C00001
100001111100000000000000000000000000000001
10000111110000000000C0000000000000C0000001
1P0011E00000000000000000000000000000000001
111111111111111111111111111111111111111111