111111111111111111111111111111111111111111111
10010000000C000000000000000000000000000C00001
100000000000000000000000000000000000000000001
1000011100000000000C0000000000000000000000001
100001110000000000000000000000000000000000001
1000011111000000000000000C0000000000000000001
10000111110000C000000000000000000000000000001
100001111100000000000000000000000000000000001
100001111100000000000000000000000C00000000001
1000011111000C000000000000C000000C00000000001
100001111100000000000000000000000C00000000001
10000111110000000000C000C00000000C00000000001
1P0011E00000000000000000000000000C00000000001
10000111110000000000C000C00000000C00000000001
10000111110000000000C000C00000000C00000000001
10000111110000000000C000C00000000C00000000001
10000111110000000000C000C00000000C00000000001
111111111111111111111111111111111111111111111